7
8 8 8 8 8 8 8
8 9 9 9 9 9 8
8 9 9 9 9 9 8
3 3 3 3 3 3 3
8 9 9 9 9 9 8
8 9 9 9 9 9 8
8 8 8 8 8 8 8
