7
9 9 9 9 9 9 9
9 8 8 8 8 8 9
9 8 1 1 1 8 9
9 8 1 9 1 8 9
9 8 1 1 1 8 9
9 8 8 8 8 8 9
9 9 9 9 9 9 9
