10
9 9 9 9 5 9 9 9 9 9
9 8 8 9 4 9 8 8 8 9
9 8 1 8 4 8 2 2 8 9
9 8 8 9 4 9 8 2 8 9
9 9 9 9 7 9 8 8 8 9
9 8 8 9 4 9 9 9 9 9
9 8 3 8 4 8 8 8 8 9
9 8 8 9 4 9 8 3 8 9
9 8 8 9 4 9 8 8 8 9
9 9 9 9 5 9 9 9 9 9
